#################
#               #
#               #
#      O       P#
#               #
#      X        #
#               #
#               # 
#################
